********** LAYOUT **********************
========================================
ID 01
----------------------------------------
01 (2)		ID
03 (20)		NOME
23 (1)		SEXO
========================================
ID 02
----------------------------------------
01 (2)		ID
03 (10)		NOME_FILHO
13 (2)		IDADE_FILHO
15 (1)		SEXO_FILHO
----------------------------------------